--------------------
--------------------
--gggg--------------
-h@...d-------------
-h+...##------------
#####M..#-----------
##gN#M..#-----------
##...+###-----------
##.#################
L....................#
##x#----------------
##x###--------------
M..#NNN###----------
##.....1.###########
####################
#####---------------
##1.#NN#####NN######
###.....#x....+!####
#######.x..#########
####################





