##N#################
#@..######NNN#######
###M..###.x....#####
#...###N#.####+#####
#.####....####...###
#..x##.#########M###
###.##.#NN#####NM###
#N#.##...+####...###
#L..#####.###.x#####
#.#####N#.##..######
#x#N##....##.#######
#...##.#####.#N#####
###M##.#N###....####
###.##...######.####
#...####.####N#.####
#M######.###..x.####
#x..####.###M#######
###.##..M###.#######
L##x.+.#####x1.#1.!#
####################